
        . . . A . . .
        . . . a . . .
        . . B a C . .
        . b . a . c .
        . . . a . . .
        . . . a . . .
        . . . a . . .
        . . . D . . .
        . . . . . . .
        