
        . . . . . . . . .
        . A a . . . . . .
        . . . . . . . . .
        B . . . . . . . C
        b . . . . . . . c
        . . . . . . . . .
        . . . D d . . . .
        . . . e . f . . .
        . . . E . F . . .
        