
        A . . . . . B
        a . . . . . b
        . . . . . . .
        . . . . . . .
        . . . . . . .
        c . . . . . d
        C . . . . . D
        