
        . A . . D . . G . . .
        . a . . d . . g . . .
        . . . . . . . . . . .
        . . . . . . . . . . .
        . . . . . . . . . . .
        . . . . . . . . . . .
        B b . . . . . . . i I
        . . . . . . . . . . .
        C c . . . . . . . j J
        