
        . . . A . . .
        . . . a . . .
        . B . . . . C
        . b . . . . c
        . . . . . . .
        . . . d . . .
        . . . D . . .
        