
        . . . . . . . . . . .
        . . . . . . . . . . .
        . . A . . . . . C . .
        . . a . . . . . c . .
        . . . . . . . . . . .
        . . . . . E . . . . .
        . . . . . e . . . . .
        . . . . . . . . . . .
        . B b . . . . . d D .
        . . . . . . . . . . .
        . . . . . . . . . . .
        