
        . . . A . . . . .
        . . . a . . . . .
        . . . . . . . . .
        B b . . . . . c C
        . . . . . . . . .
        D d . . . . . e E
        . . . . . . . . .
        . . . f . . . . .
        . . . F . . . . .
        