
        . . . . . A . . . . .
        . . . . . a . . . . .
        . . B b . . . c C . .
        . . . . . . . . . . .
        . . . . . . . . . . .
        . d . . . . . . . f .
        . D . . . . . . . F .
        . . . . . . . . . . .
        . . . . . g . . . . .
        . . . . . G . . . . .
        . . . . . . . . . . .
        