
        . . . . A . . . .
        . . . . a . . . .
        . . . . . . . . .
        . . . . . . . . .
        B b . . . . . c C
        . . . . . . . . .
        . . . . . . . . .
        . . . . d . . . .
        . . . . D . . . .
        