
        . . . . A . . . .
        . . . . a . . . .
        . . B b . c C . .
        . . . . . . . . .
        . D . . . . . f F
        . d . . . . . f .
        . . . . . . . . .
        . . . . E . . . .
        . . . . e . . . .
        . . . . . . . . .
        . . . . . . . . .
        